visitorId	INTEGER	NULLABLE
visitNumber	INTEGER	NULLABLE
visitId	INTEGER	NULLABLE
visitStartTime	INTEGER	NULLABLE
date	STRING	NULLABLE
totals	RECORD	NULLABLE
totals.visits	INTEGER	NULLABLE
totals.hits	INTEGER	NULLABLE
totals.pageviews	INTEGER	NULLABLE
totals.timeOnSite	INTEGER	NULLABLE
totals.bounces	INTEGER	NULLABLE
totals.transactions	INTEGER	NULLABLE
totals.transactionRevenue	INTEGER	NULLABLE
totals.newVisits	INTEGER	NULLABLE
totals.screenviews	INTEGER	NULLABLE
totals.uniqueScreenviews	INTEGER	NULLABLE
totals.timeOnScreen	INTEGER	NULLABLE
totals.totalTransactionRevenue	INTEGER	NULLABLE
totals.sessionQualityDim	INTEGER	NULLABLE
trafficSource	RECORD	NULLABLE
trafficSource.referralPath	STRING	NULLABLE
trafficSource.campaign	STRING	NULLABLE
trafficSource.source	STRING	NULLABLE
trafficSource.medium	STRING	NULLABLE
trafficSource.keyword	STRING	NULLABLE
trafficSource.adContent	STRING	NULLABLE
trafficSource.adwordsClickInfo	RECORD	NULLABLE
trafficSource.adwordsClickInfo.campaignId	INTEGER	NULLABLE
trafficSource.adwordsClickInfo.adGroupId	INTEGER	NULLABLE
trafficSource.adwordsClickInfo.creativeId	INTEGER	NULLABLE
trafficSource.adwordsClickInfo.criteriaId	INTEGER	NULLABLE
trafficSource.adwordsClickInfo.page	INTEGER	NULLABLE
trafficSource.adwordsClickInfo.slot	STRING	NULLABLE
trafficSource.adwordsClickInfo.criteriaParameters	STRING	NULLABLE
trafficSource.adwordsClickInfo.gclId	STRING	NULLABLE
trafficSource.adwordsClickInfo.customerId	INTEGER	NULLABLE
trafficSource.adwordsClickInfo.adNetworkType	STRING	NULLABLE
trafficSource.adwordsClickInfo.targetingCriteria	RECORD	NULLABLE
trafficSource.adwordsClickInfo.targetingCriteria.boomUserlistId	INTEGER	NULLABLE
trafficSource.adwordsClickInfo.isVideoAd	BOOLEAN	NULLABLE
trafficSource.isTrueDirect	BOOLEAN	NULLABLE
trafficSource.campaignCode	STRING	NULLABLE
device	RECORD	NULLABLE
device.browser	STRING	NULLABLE
device.browserVersion	STRING	NULLABLE
device.browserSize	STRING	NULLABLE
device.operatingSystem	STRING	NULLABLE
device.operatingSystemVersion	STRING	NULLABLE
device.isMobile	BOOLEAN	NULLABLE
device.mobileDeviceBranding	STRING	NULLABLE
device.mobileDeviceModel	STRING	NULLABLE
device.mobileInputSelector	STRING	NULLABLE
device.mobileDeviceInfo	STRING	NULLABLE
device.mobileDeviceMarketingName	STRING	NULLABLE
device.flashVersion	STRING	NULLABLE
device.javaEnabled	BOOLEAN	NULLABLE
device.language	STRING	NULLABLE
device.screenColors	STRING	NULLABLE
device.screenResolution	STRING	NULLABLE
device.deviceCategory	STRING	NULLABLE
geoNetwork	RECORD	NULLABLE
geoNetwork.continent	STRING	NULLABLE
geoNetwork.subContinent	STRING	NULLABLE
geoNetwork.country	STRING	NULLABLE
geoNetwork.region	STRING	NULLABLE
geoNetwork.metro	STRING	NULLABLE
geoNetwork.city	STRING	NULLABLE
geoNetwork.cityId	STRING	NULLABLE
geoNetwork.networkDomain	STRING	NULLABLE
geoNetwork.latitude	STRING	NULLABLE
geoNetwork.longitude	STRING	NULLABLE
geoNetwork.networkLocation	STRING	NULLABLE
customDimensions	RECORD	REPEATED
customDimensions.index	INTEGER	NULLABLE
customDimensions.value	STRING	NULLABLE
hits	RECORD	REPEATED
hits.hitNumber	INTEGER	NULLABLE
hits.time	INTEGER	NULLABLE
hits.hour	INTEGER	NULLABLE
hits.minute	INTEGER	NULLABLE
hits.isSecure	BOOLEAN	NULLABLE
hits.isInteraction	BOOLEAN	NULLABLE
hits.isEntrance	BOOLEAN	NULLABLE
hits.isExit	BOOLEAN	NULLABLE
hits.referer	STRING	NULLABLE
hits.page	RECORD	NULLABLE
hits.page.pagePath	STRING	NULLABLE
hits.page.hostname	STRING	NULLABLE
hits.page.pageTitle	STRING	NULLABLE
hits.page.searchKeyword	STRING	NULLABLE
hits.page.searchCategory	STRING	NULLABLE
hits.page.pagePathLevel1	STRING	NULLABLE
hits.page.pagePathLevel2	STRING	NULLABLE
hits.page.pagePathLevel3	STRING	NULLABLE
hits.page.pagePathLevel4	STRING	NULLABLE
hits.transaction	RECORD	NULLABLE
hits.transaction.transactionId	STRING	NULLABLE
hits.transaction.transactionRevenue	INTEGER	NULLABLE
hits.transaction.transactionTax	INTEGER	NULLABLE
hits.transaction.transactionShipping	INTEGER	NULLABLE
hits.transaction.affiliation	STRING	NULLABLE
hits.transaction.currencyCode	STRING	NULLABLE
hits.transaction.localTransactionRevenue	INTEGER	NULLABLE
hits.transaction.localTransactionTax	INTEGER	NULLABLE
hits.transaction.localTransactionShipping	INTEGER	NULLABLE
hits.transaction.transactionCoupon	STRING	NULLABLE
hits.item	RECORD	NULLABLE
hits.item.transactionId	STRING	NULLABLE
hits.item.productName	STRING	NULLABLE
hits.item.productCategory	STRING	NULLABLE
hits.item.productSku	STRING	NULLABLE
hits.item.itemQuantity	INTEGER	NULLABLE
hits.item.itemRevenue	INTEGER	NULLABLE
hits.item.currencyCode	STRING	NULLABLE
hits.item.localItemRevenue	INTEGER	NULLABLE
hits.contentInfo	RECORD	NULLABLE
hits.contentInfo.contentDescription	STRING	NULLABLE
hits.appInfo	RECORD	NULLABLE
hits.appInfo.name	STRING	NULLABLE
hits.appInfo.version	STRING	NULLABLE
hits.appInfo.id	STRING	NULLABLE
hits.appInfo.installerId	STRING	NULLABLE
hits.appInfo.appInstallerId	STRING	NULLABLE
hits.appInfo.appName	STRING	NULLABLE
hits.appInfo.appVersion	STRING	NULLABLE
hits.appInfo.appId	STRING	NULLABLE
hits.appInfo.screenName	STRING	NULLABLE
hits.appInfo.landingScreenName	STRING	NULLABLE
hits.appInfo.exitScreenName	STRING	NULLABLE
hits.appInfo.screenDepth	STRING	NULLABLE
hits.exceptionInfo	RECORD	NULLABLE
hits.exceptionInfo.description	STRING	NULLABLE
hits.exceptionInfo.isFatal	BOOLEAN	NULLABLE
hits.exceptionInfo.exceptions	INTEGER	NULLABLE
hits.exceptionInfo.fatalExceptions	INTEGER	NULLABLE
hits.eventInfo	RECORD	NULLABLE
hits.eventInfo.eventCategory	STRING	NULLABLE
hits.eventInfo.eventAction	STRING	NULLABLE
hits.eventInfo.eventLabel	STRING	NULLABLE
hits.eventInfo.eventValue	INTEGER	NULLABLE
hits.product	RECORD	REPEATED
hits.product.productSKU	STRING	NULLABLE
hits.product.v2ProductName	STRING	NULLABLE
hits.product.v2ProductCategory	STRING	NULLABLE
hits.product.productVariant	STRING	NULLABLE
hits.product.productBrand	STRING	NULLABLE
hits.product.productRevenue	INTEGER	NULLABLE
hits.product.localProductRevenue	INTEGER	NULLABLE
hits.product.productPrice	INTEGER	NULLABLE
hits.product.localProductPrice	INTEGER	NULLABLE
hits.product.productQuantity	INTEGER	NULLABLE
hits.product.productRefundAmount	INTEGER	NULLABLE
hits.product.localProductRefundAmount	INTEGER	NULLABLE
hits.product.isImpression	BOOLEAN	NULLABLE
hits.product.isClick	BOOLEAN	NULLABLE
hits.product.customDimensions	RECORD	REPEATED
hits.product.customDimensions.index	INTEGER	NULLABLE
hits.product.customDimensions.value	STRING	NULLABLE
hits.product.customMetrics	RECORD	REPEATED
hits.product.customMetrics.index	INTEGER	NULLABLE
hits.product.customMetrics.value	INTEGER	NULLABLE
hits.product.productListName	STRING	NULLABLE
hits.product.productListPosition	INTEGER	NULLABLE
hits.promotion	RECORD	REPEATED
hits.promotion.promoId	STRING	NULLABLE
hits.promotion.promoName	STRING	NULLABLE
hits.promotion.promoCreative	STRING	NULLABLE
hits.promotion.promoPosition	STRING	NULLABLE
hits.promotionActionInfo	RECORD	NULLABLE
hits.promotionActionInfo.promoIsView	BOOLEAN	NULLABLE
hits.promotionActionInfo.promoIsClick	BOOLEAN	NULLABLE
hits.refund	RECORD	NULLABLE
hits.refund.refundAmount	INTEGER	NULLABLE
hits.refund.localRefundAmount	INTEGER	NULLABLE
hits.eCommerceAction	RECORD	NULLABLE
hits.eCommerceAction.action_type	STRING	NULLABLE
hits.eCommerceAction.step	INTEGER	NULLABLE
hits.eCommerceAction.option	STRING	NULLABLE
hits.experiment	RECORD	REPEATED
hits.experiment.experimentId	STRING	NULLABLE
hits.experiment.experimentVariant	STRING	NULLABLE
hits.publisher	RECORD	NULLABLE
hits.publisher.dfpClicks	INTEGER	NULLABLE
hits.publisher.dfpImpressions	INTEGER	NULLABLE
hits.publisher.dfpMatchedQueries	INTEGER	NULLABLE
hits.publisher.dfpMeasurableImpressions	INTEGER	NULLABLE
hits.publisher.dfpQueries	INTEGER	NULLABLE
hits.publisher.dfpRevenueCpm	INTEGER	NULLABLE
hits.publisher.dfpRevenueCpc	INTEGER	NULLABLE
hits.publisher.dfpViewableImpressions	INTEGER	NULLABLE
hits.publisher.dfpPagesViewed	INTEGER	NULLABLE
hits.publisher.adsenseBackfillDfpClicks	INTEGER	NULLABLE
hits.publisher.adsenseBackfillDfpImpressions	INTEGER	NULLABLE
hits.publisher.adsenseBackfillDfpMatchedQueries	INTEGER	NULLABLE
hits.publisher.adsenseBackfillDfpMeasurableImpressions	INTEGER	NULLABLE
hits.publisher.adsenseBackfillDfpQueries	INTEGER	NULLABLE
hits.publisher.adsenseBackfillDfpRevenueCpm	INTEGER	NULLABLE
hits.publisher.adsenseBackfillDfpRevenueCpc	INTEGER	NULLABLE
hits.publisher.adsenseBackfillDfpViewableImpressions	INTEGER	NULLABLE
hits.publisher.adsenseBackfillDfpPagesViewed	INTEGER	NULLABLE
hits.publisher.adxBackfillDfpClicks	INTEGER	NULLABLE
hits.publisher.adxBackfillDfpImpressions	INTEGER	NULLABLE
hits.publisher.adxBackfillDfpMatchedQueries	INTEGER	NULLABLE
hits.publisher.adxBackfillDfpMeasurableImpressions	INTEGER	NULLABLE
hits.publisher.adxBackfillDfpQueries	INTEGER	NULLABLE
hits.publisher.adxBackfillDfpRevenueCpm	INTEGER	NULLABLE
hits.publisher.adxBackfillDfpRevenueCpc	INTEGER	NULLABLE
hits.publisher.adxBackfillDfpViewableImpressions	INTEGER	NULLABLE
hits.publisher.adxBackfillDfpPagesViewed	INTEGER	NULLABLE
hits.publisher.adxClicks	INTEGER	NULLABLE
hits.publisher.adxImpressions	INTEGER	NULLABLE
hits.publisher.adxMatchedQueries	INTEGER	NULLABLE
hits.publisher.adxMeasurableImpressions	INTEGER	NULLABLE
hits.publisher.adxQueries	INTEGER	NULLABLE
hits.publisher.adxRevenue	INTEGER	NULLABLE
hits.publisher.adxViewableImpressions	INTEGER	NULLABLE
hits.publisher.adxPagesViewed	INTEGER	NULLABLE
hits.publisher.adsViewed	INTEGER	NULLABLE
hits.publisher.adsUnitsViewed	INTEGER	NULLABLE
hits.publisher.adsUnitsMatched	INTEGER	NULLABLE
hits.publisher.viewableAdsViewed	INTEGER	NULLABLE
hits.publisher.measurableAdsViewed	INTEGER	NULLABLE
hits.publisher.adsPagesViewed	INTEGER	NULLABLE
hits.publisher.adsClicked	INTEGER	NULLABLE
hits.publisher.adsRevenue	INTEGER	NULLABLE
hits.publisher.dfpAdGroup	STRING	NULLABLE
hits.publisher.dfpAdUnits	STRING	NULLABLE
hits.publisher.dfpNetworkId	STRING	NULLABLE
hits.customVariables	RECORD	REPEATED
hits.customVariables.index	INTEGER	NULLABLE
hits.customVariables.customVarName	STRING	NULLABLE
hits.customVariables.customVarValue	STRING	NULLABLE
hits.customDimensions	RECORD	REPEATED
hits.customDimensions.index	INTEGER	NULLABLE
hits.customDimensions.value	STRING	NULLABLE
hits.customMetrics	RECORD	REPEATED
hits.customMetrics.index	INTEGER	NULLABLE
hits.customMetrics.value	INTEGER	NULLABLE
hits.type	STRING	NULLABLE
hits.social	RECORD	NULLABLE
hits.social.socialInteractionNetwork	STRING	NULLABLE
hits.social.socialInteractionAction	STRING	NULLABLE
hits.social.socialInteractions	INTEGER	NULLABLE
hits.social.socialInteractionTarget	STRING	NULLABLE
hits.social.socialNetwork	STRING	NULLABLE
hits.social.uniqueSocialInteractions	INTEGER	NULLABLE
hits.social.hasSocialSourceReferral	STRING	NULLABLE
hits.social.socialInteractionNetworkAction	STRING	NULLABLE
hits.latencyTracking	RECORD	NULLABLE
hits.latencyTracking.pageLoadSample	INTEGER	NULLABLE
hits.latencyTracking.pageLoadTime	INTEGER	NULLABLE
hits.latencyTracking.pageDownloadTime	INTEGER	NULLABLE
hits.latencyTracking.redirectionTime	INTEGER	NULLABLE
hits.latencyTracking.speedMetricsSample	INTEGER	NULLABLE
hits.latencyTracking.domainLookupTime	INTEGER	NULLABLE
hits.latencyTracking.serverConnectionTime	INTEGER	NULLABLE
hits.latencyTracking.serverResponseTime	INTEGER	NULLABLE
hits.latencyTracking.domLatencyMetricsSample	INTEGER	NULLABLE
hits.latencyTracking.domInteractiveTime	INTEGER	NULLABLE
hits.latencyTracking.domContentLoadedTime	INTEGER	NULLABLE
hits.latencyTracking.userTimingValue	INTEGER	NULLABLE
hits.latencyTracking.userTimingSample	INTEGER	NULLABLE
hits.latencyTracking.userTimingVariable	STRING	NULLABLE
hits.latencyTracking.userTimingCategory	STRING	NULLABLE
hits.latencyTracking.userTimingLabel	STRING	NULLABLE
hits.sourcePropertyInfo	RECORD	NULLABLE
hits.sourcePropertyInfo.sourcePropertyDisplayName	STRING	NULLABLE
hits.sourcePropertyInfo.sourcePropertyTrackingId	STRING	NULLABLE
hits.contentGroup	RECORD	NULLABLE
hits.contentGroup.contentGroup1	STRING	NULLABLE
hits.contentGroup.contentGroup2	STRING	NULLABLE
hits.contentGroup.contentGroup3	STRING	NULLABLE
hits.contentGroup.contentGroup4	STRING	NULLABLE
hits.contentGroup.contentGroup5	STRING	NULLABLE
hits.contentGroup.previousContentGroup1	STRING	NULLABLE
hits.contentGroup.previousContentGroup2	STRING	NULLABLE
hits.contentGroup.previousContentGroup3	STRING	NULLABLE
hits.contentGroup.previousContentGroup4	STRING	NULLABLE
hits.contentGroup.previousContentGroup5	STRING	NULLABLE
hits.contentGroup.contentGroupUniqueViews1	INTEGER	NULLABLE
hits.contentGroup.contentGroupUniqueViews2	INTEGER	NULLABLE
hits.contentGroup.contentGroupUniqueViews3	INTEGER	NULLABLE
hits.contentGroup.contentGroupUniqueViews4	INTEGER	NULLABLE
hits.contentGroup.contentGroupUniqueViews5	INTEGER	NULLABLE
hits.dataSource	STRING	NULLABLE
fullVisitorId	STRING	NULLABLE
userId	STRING	NULLABLE
channelGrouping	STRING	NULLABLE
socialEngagementType	STRING	NULLABLE
